111111111111111111111
100000000000P00000001
10000000000E000000001
10000000000C000000001
111111111111111111111