111111111111111111111
111111111111111111111
11000000000E000000011
1100000C0000000000011
1100000000000P0000011
111111111111111111111
111111111111111111111