##################
#1111111111111111#
#110000000000E011#
#1100000100000011#
#11C0000000000P11#
#1111111111111111#
##################