1111111111111111111111111111111
1111111111111111111111111111111
110000000000X000000C00000000011
111111X101011101010111010111011
11000X010000XC0000X0010X0X01011
1101010101010111010101010101011
110101C0100000000X00000X0010011
1101010101010101110101011101011
110001000C01000X000000000X0X011
1101010101110101011101010101011
110000C0X0001001000C10000C00011
1101010101X10101010101010101011
110100000X010X0C100000100000011
11010101011101110101010111X1011
11000001000X00PXC001000C0010011
1101010101010101011101010101011
1100000000X00XCXEX0000000000111
1101011101010101111101010111011
110000000000000100001000X001011
1101010111010101010111010101011
11000100000C0000000000100001001
1101010101010101010101010101011
1100000X000001000000X00X000X011
1101010101010101110101010101011
11000000100000X0000000C00000011
1101011101010101X11101010111011
110100000001000X00C001000001011
1101010111010101110101010111011
110000000X0C0000X00000000000011
1111111111111111111111111111111
