111111111111111111
10000C000010000111
100000000C10000111
1000E0C00010000111
100000010010000111
100000000010000111
100P00000010000111
111111000010000001
10000000X010000111
100000000010000111
100000000010000111
111111000010000001
100000010010000111
100000000010000111
100000000010000111
111111000010000001
100000010010000111
100000000010000111
100000000010000111
111111000010000001
100000000010000111
100000000010000111
111111000010000001
111111111111111111