111111111111111111
10000C000000000111
100000000000000111
1000E0C0000C000111
100000000000000111
100000000000000111
100P0000000X000111
111111000000000001
111111111111111111