111111111111111111
100000000001000111
10000000P011000111
10C0E0C00001000111
100001111001000111
1000000X00C1000111
111100001101111111
100000000000000001
111111111111111111