111111111111111111
10000C000010000111
100000000C10000111
100000C00010000111
1000000X0010000111
10000000001000C111
10P000000010000111
1111110000E0000001
111111111111111111
