111111111111111111
10000C000010000111
100000000C10000111
1000E0C00010000111
1000000X0010000111
100000000010000111
100P00000010000111
111111000010000001
111111111111111111
