1111111111111111
1000000000000001
1000000000000C01
10C000C000001111
1000011110000001
10P0000000C000E1
1111000001101111
1111111111111111