1111111111111111
1000000000000001
1000000000000C01
10C000C000000001
1000011110P00001
1000000000C00001
111100001100E001
1111111111111111