11111111111
10011C11001
1011C0C1101
111C000C111
11C00010C11
1P0100000E1
11000000011
11100100111
10110001101
10011011001
11111111111